1111111111111111111111
1E0X00000X00000C000C01
1010010100100000101001
1010010010101010X01001
1PX00000C00C0000000001
1111111111111111111111