1111111111111111111111111111111111
1E0000000000000C00000C000000X00001
101X010100100000101001000000010101
1E10010010101010001001000X00010101
1PE000000C00C000X000000000000000C1
1111111111111111111111111111111111