111111111111111111111111111111111111
100000000000000X0C000000000000000001
1011111C1111111110100111111111100001
10C111111100000C101000000000XXX00001
10110111X100X0X01X100000011111110101
10000100010X10X0XE00XXX1000000000101
1X010101010X1CX01X111111111111111101
1101P0010000111100000000000000000001
1101111111111111111111111111101XXX11
1X00000000000000000000000000000000C1
111111111111111111111111111111111111